111111111111111111
1P0000000000000001
100000CCC000000001
10000CCCCC00000001
1000CCCC00C0000001
1000CCCC00C0000001
1000CCCCCC00000001
1000CCCCCC00000001
10000CC0CC00000001
10000CC0CC00000001
1000000000000000E1
111111111111111111
