111111111111111111111111111111
10000000100010000000000000C011
100000000001111110001111000011
100001P1100000E100000000000001
100001111000001111111000111001
1000000000000000010000C0000001
100000111111100000000000000001
100000000C00000000000000000001
100011111100111111111000000001
1000000000000001C0000000000001
100000111000111111111111111001
1000001000000000000C1111000001
100000100011111111111111111001
10000000000000000000C100000001
100011111111100011111111111001
1000000C000000000C000000000001
100000111000111111000000000001
10000011100C111111111100000001
100000111000000000000100000001
100000100000000000000000000001
100000100011111111111111000001
100000000000000C111C0000000001
100011100001111111111111100001
100000000000000000000000000001
100000111000111111111111000001
100000111C00000000100000000001
100000111111100000000000000001
100000000000000000000111111111
111111111111111111111111111111
